         ^ ^ ^ ^ ^ ^ ^ # # # # # # # # @ @
         ^ ^ ^ ^ ^ ^ # # # # # # # # # @ @
         ^ ^ ^ ^ ^ # # # # # # # # # @ @ @
         ^ ^ ^ ^ ^ # # # # # # # @ @ @ @ @
         ^ ^ ^ @ @ @ @ @ # # # @ @ @ @ @ @
         @ @ @ @ @ @ @ @ @ @ @ @ @ @ @ @ @
         @ @ @ @ . . . . . + - - - - - - X
         @ @ @ @ @ . . . . | @ @ @ @ @ @ @
         @ @ @ @ @ @ . . . | @ @ @ @ @ @ @
         - - - - - - - - - + @ @ @ @ @ @ @
         @ @ @ @ @ @ @ @ @ @ @ . @ @ @ @ @
         @ @ @ . @ @ @ @ @ @ @ . . . % % %
         @ @ % . . % % % % % % % . . . % %
         @ % % . . . % % % % % % . . . . %
         % % % % % % % % % % % % % . . % .
         % % % % % % % % % % % % % % % % %
