^ ^ ^ ^ ^ ^ ^ # # # # # # # # @
^ ^ ^ ^ ^ ^ # # # # # # # # # @
^ ^ ^ ^ ^ # # # # # # # # # @ @
^ ^ ^ ^ ^ # # # # # # # @ @ @ @
^ ^ ^ @ @ @ @ @ # # # @ @ @ @ @
@ @ @ @ @ @ @ @ @ @ @ @ @ @ @ @
@ @ @ @ . . . . . + - - - - - -
@ @ @ @ @ . . . . | @ @ @ @ @ @
@ @ @ @ @ @ . . . | @ @ @ @ @ @
- - - - - - - - - + @ @ @ @ @ @
@ @ @ @ @ @ @ @ @ @ @ . @ @ @ @
@ @ @ . @ @ @ @ @ @ @ . . . % %
@ @ % . . % % % % % % % . . . %
@ % % . . . % % % % % % . . . .
% % % % % % % % % % % % % . . %
% % % % % % % % % % % % % % % % 
