^ ^ ^ ^ ^ ^ ^ # # # # # # # # @
^ ^ ^ ^ ^ ^ # # # # # # # # # @
^ ^ ^ ^ ^ # # # # # # # # # @ @
^ ^ ^ ^ ^ # # # # # # # @ @ @ @
^ ^ ^ @ @ @ @ @ # # # @ @ @ @ @
@ @ @ @ @ @ @ @ @ @ @ @ @ @ @ @
@ @ @ @ . . . . . + - - - - - -
@ @ @ @ @ . . . . | @ @ @ @ @ @
@ @ @ @ @ @ . . . | @ @ @ @ @ @
- - - - - - - - - + @ @ @ @ @ @
@ @ @ @ @ @ @ @ @ @ @ . @ @ @ @
@ @ @ . @ @ @ @ @ @ @ . . . % %
@ @ % . . % % % % % % % . . . %
@ % % . . . % % % % % % . . . .
% % % % % % % % % % % % % . . %
% % % % % % % % % % % % % % % % 

^ ^ ^ ^ ^ ^ ^ ^ ^ ^ ^ ^ ^ ^ ^ ^
^ ^ ^ ^ @ ^ ^ ^ ^ ^ ^ ^ ^ ^ ^ ^
^ ^ ^ ^ @ ^ ^ ^ ^ ^ ^ ^ ^ ^ ^ ^
^ ^ ^ ^ @ @ ^ ^ ^ ^ ^ ^ ^ ^ ^ ^
^ ^ ^ ^ @ @ @ ^ ^ ^ ^ ^ ^ ^ ^ ^
^ ^ ^ ^ @ @ @ @ ^ ^ ^ ^ @ @ @ @
^ ^ ^ ^ @ @ @ @ @ @ @ @ @ @ @ @


- - - - - - - - - - - - - - - -