      *         *
      |         |
    *-*-*       *                                                                               
    | | |       |                     
    *-*-*   *   *   * *-*-*-*-*
      |     |   |   | | | | | |
*-*-*-*-*-*-*-*-*-*-*-*-*-*-*-*
    |   |   |   |     | | | | |
  *-*   *   *   *     *-*-*-*-* 
    |       |   |     
*-*-*-*-*   *-* *     
                |
                *
