~~~~~~~~~~~~~~~~~~~~~~~~~~~~~~~~~~~~~~~~~~~~~~~~~~~~~~~~~~~~~~~
~~~~~~~~~~~~~~~~~~~~~~~~~~~~~~~~~~~~~~~~~~~~~~~~~~~~~~~~~~~~~~~
~~~~~~~~~~~~~~~~~~~~~~~~~~~~~~~~~~~~~~~~~~~~~~~~~~~~~~~~~~~~~~~
~~~~~~~~~~~~~~~~~:::::~~~~~~~~~~::~~~~~~~~~~~~:::~~~~~~~~~~~~~~
~~~~~~~~~~:::::::::::::~~~::::~~::::~~~~~~::::::~::~~~~~~~~~~~~
~~~~~~::::::***:::::*:::~:::*:::::::::~~~::::::~~:::~~~~~~~~~~~
~~~~~::::*******:::***::::****::::::::::::::::~~:::::~~~~~~~~~~
~~~~~~::::*******:******:********:::^^::::MMM~~::::~~~~~~~~~~~~
~~~~~::M::**********************::^^^^^::MMM~~^::~~~~~~~~~~~~~~
~~~~~:MMM************************^^^^^::MMM~~^^:::~~~~~~~~~~~~~
~~~~~MMM::*******************::^^^^^:::::M~~^^::::::~~~~~~~~~~~
~~~~MMM::******:**********::::^^^::MMMM:MM~~^^^:::@@::~~~~~~~~~
~~~~MMMM::***:::******::::::^^^:::MMMMMMMMM~~^^::@@@@:::~~~~~~~
~~~~MM::***::::::::**::::::::^::MMMMMMMM~~~~^^:@@@@@:::::~~~~~~
~~~~M::*****::::::::*::::::^^M:MMMMM~~~~~::^^^^^@@@@@::~~~~~~~~
~~~~::::**::::::::::::::^^MMMMMM~~~~~~::::^^^@@@@@@::::~~~~~~~~
~~~~~::::*::::::::::::^^^MM~~~~~~~::::::^^^@@@@@:::::::::~~~~~~
~~~~~~:::::::::::::MMMM~~~~~~:::::::::@@::^@@@:::::::::::::~~~~
~~~~~~~~:::::::::MMMMM~~~::::::::::@@@@::::^@@@@@@::::~~~~~~~~~
~~~~~::~~~::::MMMM::::~~::::::::@@@@@@:::::::@@@:::::::~~~~~~~~
~~~~~~:::~~:::::M:::::~~::::@@@@@@::::::@@::::@:::::~~~~~~~~~~~
~~~~~~::::~~~~:::M:::~~~~::@@@@@:::::::@@@@@@::::~~~~~~~~~~~~~~
~~~~~::@::::~~~~~::~~~~~~~::@::::::@@@@@@@@::::~~~~~~~~~~~~~~~~
~~~~~~@@@@:::~~~~~~~~~~::::::::::@@@@@@@@@@@@@::~~~~~~~~~~~~~~~
~~~~~~~@@:::~~~~~~~~~~::::::::M^^:@@@@@@@@:::::~~~~~~~~~~~~~~~~
~~~~~~~~~::~~~~~~~~~~~~::::MMM^^:::@@::@@@@:~~~~~~~~~~~~~~~~~~~
~~~~~~~~~~~~~~~~~~~::::::MM^^^::::::::@@@@@@::~~~~~~~~~~~~~~~~~
~~~~~~~~~~~~~:::::::::MMM^^^:::::::@@@@@@@::~~~~~~~~~~~~~~~~~~~
~~~~~~~~~~~~~~~:::::::MM^^::::::@@@@@@:::@@~~~~~~~~~~~~~~~~~~~~
~~~~~~~~~~~~~~~~~::MMM^^::^^::::@@@@:::::@~~~~~~~~~~~~~~~~~~~~~
~~~~~~~~~~~~~~~~~~~MMM^:::^^^:::::@@:::@@~~~~~~~~~~~~~~~~~~~~~~
~~~~~~~~~~~~~~~~~~~~~MM^^:^^:::::@@@@@:~~~~~~~~~~~~~~~~~~~~~~~~
~~~~~~~~~~~~~~~~~~~~~~~MM^^:::::@@@@@:~~~~~~~~~~~~~~~~~~~~~~~~~
~~~~~~~~~~~~~~~~~~~~~~~~MM^^^::@@@@:~~~~~~~~~~~~~~~~~~~~~~~~~~~
~~~~~~~~~~~~~~~~~~~~~~~M^^^:::@@::~~~~~~~~~~~~~~~~~~~~~~~~~~~~~
~~~~~~~~~~~~~~~~~~~~~~~~M^^^::::~~~~~~~~~~~~~~~~~~~~~~~~~~~~~~~
~~~~~~~~~~~~~~~~~~~~~~~~~M^^:::~~~~~~~~~~~~~~~~~~~~~~~~~~~~~~~~
~~~~~~~~~~~~~~~~~~~~~~~~~~~^:~~~~~~~~~~~~~~~~~~~~~~~~~~~~~~~~~~
~~~~~~~~~~~~~~~~~~~~~~~~~~~~~~~~~~~~~~~~~~~~~~~~~~~~~~~~~~~~~~~
~~~~~~~~~~~~~~~~~~~~~~~~~~~~~~~~~~~~~~~~~~~~~~~~~~~~~~~~~~~~~~~
~~~~~~~~~~~~~~~~~~~~~~~~~~~~~~~~~~~~~~~~~~~~~~~~~~~~~~~~~~~~~~~