........_______________________........
......./.#####################.\.......
....../.##........#..........##.\......
...../.##.........#...........##.\.....
..../.@#..........#............##.\....
.../.##...........#.............##.\...
../.##............#..............##.\..
./.##.............#...............##.\.
(..###############O#################..)
.\.####...........#.............####./.
..\...#...........#.............#.../..
...\..#...........#.............#../...
....\.###.........#...........###./....
.....\..#.........#...........#../.....
......\.##########@############./......
.......\_______________________/.......

